....#...#.
##.#..#..#
#.....#..#
..##..####
#..##.##..
.#..######
#.#....#.#
#.#...#.#.
.###.#.##.
##....#...
\robot 3 0
