.#.......#..##.#..#.##...#.......#.#...#
.#......#.................##...#...#...#
#..#..##..####...#.#...#.##..#.....#...#
.#..##.##.####..#....##..#......#..#...#
..#....#..#..#......##.#.##.#.###..#.#..
.#........##..#.##.....#.###...#...#.##.
##.#...#.....####...#.#....#.#.#...#....
...#..#.##..#.###...#.#.#......#..#..#..
###...#...##..#..#..#.##..#...#..#.#..#.
.#.....#....#..####..#.#.....##...#.....
#.#.#..##...#...##...........#.##.##....
....##..###...##.......##.#....#.#.#....
#.###.............#.......#..#.....#....
...#...#.#...#....##..#####..#.#.....##.
.##.....#....##..........#####.####.....
#..#..#......#.........#.#..#...........
#.#..#.#.........###..#..#...#......####
.........#...#...........##..###...#....
..#..#..##..#..#...#...#...##.#....##...
.#...##...#.#.##....#..###..#..#..#....#
.....#....#.#.#.##...#..#..#..#.#.......
.##..###.##..#..#...........#..###...#.#
#...#..#..#...#...#.###...#.#.#.###.....
.#..####.#.##..#....###...#.....#.....#.
.....#...#..#.#.###..#.###....#..##.###.
#..........####..###.##......#.###.#....
..#..#.......#.#..#..#.#.....#....##...#
..#.......#.#..#.##...#.##.#.......#.#..
#.....#..##....#....#...#.....#......#..
..#.........##...###.##.#...#.......#.#.
.#.....#..#......###...#.............##.
..#...#.#####.....##....#.........#...#.
...#.....#..#......##..##.#...##...#.#..
......##.###....#..###...##..#.#........
.#.#..##...#.#.#..#...####..##....#.#..#
#......#.#..#........#..#....#.....#..#.
..........#...#.....#...#.#..#..#.##....
..#..#.......#....##....##..#..#....#..#
#..#.#......#.#..#.....#....#....####...
.....#.#.###.#....####......#...........
\robot 0 0
\robot 1 0
