..#..#....##..#..#..
.#......##....#..#.#
#......#...#.#.##.##
....#.#.##.##....#..
...#...#.#.#..##.#..
##..###.#.....#.#.#.
.#............#..#.#
.#...####...#..#.###
.##........#.....##.
#..#......#.....#..#
...##.#...###.##...#
.#...#...........#.#
.......#....#....#..
..#.#.##.....#.#..#.
...###.#...#.#..#.#.
.#..#....#.##...#...
.##.##..#...#...#...
#......#...#..#..#..
#..#...##..#....#...
#.##.......#......##
\robot 13 14
\robot 15 0
\robot 7 4
