....#...##
.....#...#
....#.#...
....#.....
..#..#...#
...#.#....
##..##.#.#
...#.#.#.#
#.......#.
...##.....
.....##..#
\robot 7 2
\robot 3 6
\robot 2 7
